555555555555555555555555555555
533333000000000000000000000005
533333000000000000000000000005
533433000000000000000000000005
533333000000000000000000000005
533333000000000000000000000005
500000000000000000000000000005
500000000000055000000000000005
500000000000555500000000000005
500000000000555500000000000005
500000000000055000000000000005
500000000000000000000000000005
500000000000000000000000111115
500000000000000000000000111115
500000000000000000000000112115
500000000000000000000000111115
500000000000000000000000111115
555555555555555555555555555555