55555555555555555555555555555555
53333300000000000000000000000005
53333300000000000000000000000005
53343300000000000000000000000005
53333300000000000000000000000005
53333300000000000000000000000005
50000000000000000000000000000005
50000000000000000000000000000005
50000000000000550000000000000005
50000000000005555000000000000005
50000000000005555000000000000005
50000000000000550000000000000005
50000000000000000000000000000005
50000000000000000000000000000005
50000000000000000000000000111115
50000000000000000000000000111115
50000000000000000000000000112115
50000000000000000000000000111115
50000000000000000000000000111115
55555555555555555555555555555555