55555555555
50033333005
50033333005
50033433005
50033333005
50033333005
50000000005
50000000005
50000000005
50000000005
50000000005
50000000005
50000000005
50000000005
50000000005
50000000005
50000000005
50000000005
50000000005
50000000005
50000000005
50000000005
50000000005
50000000005
50000000005
50000000005
50000000005
50000000005
50000000005
50000000005
50000000005
50000000005
50000000005
50000000005
50000000005
50000000005
50000000005
50000000005
50000000005
50011111005
50011111005
50011211005
50011111005
50011111005
55555555555